NO ./texture/T1024/TILE05.xpm
SO ./texture/T1024/TILE03.xpm
WE ./texture/T1024/TILE02.xpm
EA ./texture/T1024/TILE04.xpm
C 225,229,175
F 134,111,88
        1111111111111111111111111
        1000000010000000000000001
        1000000010000000000000001111111
        1000000010000000000000001000001
111111111111011111111011111101111000001     111111111111111                      1111111111
10000000000000000000000000000000111011111111100000000000001                      10000000011
10000000000000000100100100100100000000000000000111111111001                      100000000011
100000000000000010000000000000100000000000000001       100111111111111111111111111000000000011
10E000000000000010000000000000100000000000000001       100000000000000000000000000000000000001
100000000000000001001001001001000000000000000001       100111111111111111111111111000000000011
10000000000000000000000000000000000000000000000111111111001                      100000000011
10000001110000011100000000000000000000111111110000000000001                      10000000011
10000001 1000001 1000000000000000000001      11111111111111                      1111111111
10000001 1111111 1000001010000000000001
11101111         1111111011111111111111
  101                  101
  101111111111111111111101
  100000000000000000000001
  111111111111111111111111
