NO ./texture/T1024/TILE05.xpm
SO ./texture/T1024/TILE03.xpm
WE ./texture/T1024/TILE02.xpm
EA ./texture/T1024/TILE04.xpm
PC ./texture/T1024/TILE07.xpm
DOOR ./texture/T1024/DOOR_01.xpm
PF ./texture/T1024/TILE06.xpm
        1111111111111111111111111
        1000000010000000000000001
        1000000010000000000000001111111
        1000000010000000000000001000001
111111111111D11111111D111111D1111000001     111111111111111                      1111111111
10000000000000000000000000000000111D11111111100000000000001                      10000000011
10000000000000000100100100100100000000000000000111111111001                      100000000011
100000000000000010000000000000100000000000000001       100111111111111111111111111000000000011
10E000000000000010000000000000100000000000000001       1000D000000000000000000000D000000000001
100000000000000001001001001001000000000000000001       100111111111111111111111111000000000011
10000000000000000000000000000000000000000000000111111111001                      100000000011
10000001110000011100000000000000000000111111110000000000001                      10000000011
10000001 1000001 1000000000000000000001      11111111111111                      1111111111
10000001 1111111 1000001D10000000000001
111D1111         1111111011111111111111
  101                  101
  101111111111111111111101
  100000000000000000000001
  111111111111111111111111
